Country,Confirmed,Deaths,Recovered,Active,New Cases,Deaths / 100 Cases,Recovered / 100 Cases,Deaths / 100 Recovered,Population,Cases / Million People,Confirmed last week,1 week change,1 week % increase
Afghanistan,156739,7297,0,149442,0,4.66,0.0,0.0,38928341,4026.0,156456,283,0.18
Albania,195021,3022,0,191999,549,1.55,0.0,0.0,2877800,67767.0,191440,3581,1.87
Algeria,208532,6009,0,202523,152,2.88,0.0,0.0,43851043,4755.0,207624,908,0.44
Andorra,16035,130,0,15905,63,0.81,0.0,0.0,77265,207533.0,15744,291,1.85
Angola,64985,1729,0,63256,17,2.66,0.0,0.0,32866268,1977.0,64857,128,0.2
Antigua and Barbuda,4129,108,0,4021,0,2.62,0.0,0.0,97928,42164.0,4102,27,0.66
Argentina,5312089,116341,0,5195748,1755,2.19,0.0,0.0,45195777,117535.0,5302445,9644,0.18
Armenia,331914,7183,0,324731,1019,2.16,0.0,0.0,2963234,112011.0,325521,6393,1.96
Australia,195617,1933,0,193684,1505,0.99,0.0,0.0,50919400,3842.0,187041,8576,4.59
Austria,1011465,11903,0,999562,15145,1.18,0.0,0.0,9006400,112305.0,923150,88315,9.57
Azerbaijan,568089,7551,0,560538,2124,1.33,0.0,0.0,10139175,56029.0,554096,13993,2.53
Bahamas,22640,671,0,21969,11,2.96,0.0,0.0,393248,57572.0,22552,88,0.39
Bahrain,277304,1393,0,275911,22,0.5,0.0,0.0,1701583,162968.0,277165,139,0.05
Bangladesh,1573458,27939,0,1545519,244,1.78,0.0,0.0,164689383,9554.0,1571906,1552,0.1
Barbados,23175,205,0,22970,252,0.88,0.0,0.0,287371,80645.0,21311,1864,8.75
Belarus,634731,4901,0,629830,1844,0.77,0.0,0.0,9449321,67172.0,621689,13042,2.1
Belgium,1559998,26526,0,1533472,16699,1.7,0.0,0.0,22985282,67869.0,1463548,96450,6.59
Belize,29501,558,0,28943,115,1.89,0.0,0.0,397621,74194.0,28749,752,2.62
Benin,24846,161,0,24685,13,0.65,0.0,0.0,12123198,2049.0,24833,13,0.05
Bhutan,2629,3,0,2626,0,0.11,0.0,0.0,771612,3407.0,2623,6,0.23
Bolivia,527380,19049,0,508331,1074,3.61,0.0,0.0,11673029,45179.0,521518,5862,1.12
Bosnia and Herzegovina,267851,12180,0,255671,857,4.55,0.0,0.0,3280815,81642.0,262906,4945,1.88
Botswana,194445,2416,0,192029,316,1.24,0.0,0.0,2351625,82685.0,193701,744,0.38
Brazil,21989962,612144,0,21377818,12301,2.78,0.0,0.0,422706534,52022.0,21924598,65364,0.3
Brunei,14399,96,0,14303,21,0.67,0.0,0.0,437483,32913.0,14058,341,2.43
Bulgaria,668363,26985,0,641378,2785,4.04,0.0,0.0,6948445,96189.0,650063,18300,2.82
Burkina Faso,15514,265,0,15249,0,1.71,0.0,0.0,20903278,742.0,15281,233,1.52
Burma,516146,18989,0,497157,587,3.68,0.0,0.0,54409800,9486.0,510725,5421,1.06
Burundi,20321,38,0,20283,16,0.19,0.0,0.0,11890781,1709.0,20210,111,0.55
Cabo Verde,38313,350,0,37963,4,0.91,0.0,0.0,555988,68910.0,38287,26,0.07
Cambodia,119741,2887,0,116854,54,2.41,0.0,0.0,16718971,7162.0,119358,383,0.32
Cameroon,106190,1770,0,104420,0,1.67,0.0,0.0,26545864,4000.0,106190,0,0.0
Canada,1767962,29516,0,1738446,2798,1.67,0.0,0.0,76492216,23113.0,1749800,18162,1.04
Central African Republic,11666,101,0,11565,0,0.87,0.0,0.0,4829764,2415.0,11579,87,0.75
Chad,5107,175,0,4932,0,3.43,0.0,0.0,16425859,311.0,5107,0,0.0
Chile,1735187,38049,0,1697138,2611,2.19,0.0,0.0,36692988,47289.0,1718085,17102,1.0
China,110899,4849,0,106050,28,4.37,0.0,0.0,2829703778,39.0,110553,346,0.31
Colombia,5040665,127963,0,4912702,2121,2.54,0.0,0.0,99141018,50843.0,5024263,16402,0.33
Comoros,4437,149,0,4288,28,3.36,0.0,0.0,869595,5102.0,4352,85,1.95
Congo (Brazzaville),18539,331,0,18208,0,1.79,0.0,0.0,89561403,207.0,18153,386,2.13
Congo (Kinshasa),57803,1099,0,56704,0,1.9,0.0,0.0,5518087,10475.0,57662,141,0.24
Costa Rica,565347,7248,0,558099,251,1.28,0.0,0.0,5094114,110980.0,563924,1423,0.25
Cote d'Ivoire,61553,702,0,60851,17,1.14,0.0,0.0,26378274,2333.0,61486,67,0.11
Croatia,558270,10113,0,548157,7270,1.81,0.0,0.0,4105268,135989.0,521837,36433,6.98
Cuba,959869,8289,0,951580,316,0.86,0.0,0.0,11326616,84745.0,957735,2134,0.22
Cyprus,129158,589,0,128569,388,0.46,0.0,0.0,1207361,106975.0,126772,2386,1.88
Czechia,1944400,31769,0,1912631,14186,1.63,0.0,0.0,10708981,181567.0,1856555,87845,4.73
Denmark,443017,2803,0,440214,4079,0.63,0.0,0.0,5942850,74546.0,416326,26691,6.41
Diamond Princess,712,13,0,699,0,1.83,0.0,0.0,0,50406.678756476686,712,0,0.0
Djibouti,13500,186,0,13314,0,1.38,0.0,0.0,988002,13664.0,13494,6,0.04
Dominica,5550,35,0,5515,109,0.63,0.0,0.0,71991,77093.0,5235,315,6.02
Dominican Republic,399773,4182,0,395591,893,1.05,0.0,0.0,10847904,36853.0,392223,7550,1.92
Ecuador,521792,33088,0,488704,0,6.34,0.0,0.0,17643060,29575.0,519560,2232,0.43
Egypt,347719,19780,0,327939,911,5.69,0.0,0.0,102334403,3398.0,341188,6531,1.91
El Salvador,118041,3741,0,114300,0,3.17,0.0,0.0,6486201,18199.0,117350,691,0.59
Equatorial Guinea,13519,169,0,13350,0,1.25,0.0,0.0,1402985,9636.0,13485,34,0.25
Eritrea,7112,53,0,7059,21,0.75,0.0,0.0,3546427,2005.0,7013,99,1.41
Estonia,215367,1714,0,213653,871,0.8,0.0,0.0,1326539,162353.0,209597,5770,2.75
Eswatini,46485,1248,0,45237,1,2.68,0.0,0.0,1160164,40068.0,46465,20,0.04
Ethiopia,369667,6655,0,363012,230,1.8,0.0,0.0,114963583,3216.0,368106,1561,0.42
Fiji,52444,694,0,51750,0,1.32,0.0,0.0,896444,58502.0,52356,88,0.17
Finland,173632,1246,0,172386,1259,0.72,0.0,0.0,5540718,31337.0,167119,6513,3.9
France,7453941,119333,0,7334608,20396,1.6,0.0,0.0,68128061,109411.0,7358920,95021,1.29
Gabon,36943,270,0,36673,0,0.73,0.0,0.0,2225728,16598.0,36587,356,0.97
Gambia,9986,341,0,9645,0,3.41,0.0,0.0,2416664,4132.0,9980,6,0.06
Georgia,800293,11289,0,789004,4446,1.41,0.0,0.0,3989175,200616.0,771381,28912,3.75
Germany,5271961,98751,0,5173210,58768,1.87,0.0,0.0,166310062,31700.0,4957374,314587,6.35
Ghana,130727,1207,0,129520,0,0.92,0.0,0.0,31072945,4207.0,130649,78,0.06
Greece,861117,17075,0,844042,7276,1.98,0.0,0.0,10423056,82617.0,815068,46049,5.65
Grenada,5865,200,0,5665,0,3.41,0.0,0.0,112519,52125.0,5863,2,0.03
Guatemala,611374,15775,0,595599,0,2.58,0.0,0.0,17915567,34125.0,608307,3067,0.5
Guinea,30715,387,0,30328,0,1.26,0.0,0.0,13132792,2339.0,30715,0,0.0
Guinea-Bissau,6434,146,0,6288,2,2.27,0.0,0.0,1967998,3269.0,6263,171,2.73
Guyana,37090,968,0,36122,91,2.61,0.0,0.0,786559,47155.0,36533,557,1.52
Haiti,24710,711,0,23999,0,2.88,0.0,0.0,11402533,2167.0,24233,477,1.97
Holy See,27,0,0,27,0,0.0,0.0,0.0,809,33375.0,27,0,0.0
Honduras,377293,10372,0,366921,0,2.75,0.0,0.0,9904608,38093.0,376841,452,0.12
Hungary,987199,32645,0,954554,10767,3.31,0.0,0.0,9660350,102191.0,931414,55785,5.99
Iceland,16243,34,0,16209,130,0.21,0.0,0.0,341250,47599.0,15140,1103,7.29
India,34489623,465082,0,34024541,11106,1.35,0.0,0.0,2751341248,12536.0,34414186,75437,0.22
Indonesia,4252345,143709,0,4108636,400,3.38,0.0,0.0,273523621,15547.0,4249758,2587,0.06
Iran,6063775,128634,0,5935141,5882,2.12,0.0,0.0,83992953,72194.0,6019947,43828,0.73
Iraq,2072478,23607,0,2048871,789,1.14,0.0,0.0,40222503,51525.0,2066905,5573,0.27
Ireland,515691,5609,0,510082,4646,1.09,0.0,0.0,4937796,104437.0,484523,31168,6.43
Israel,1339258,8154,0,1331104,445,0.61,0.0,0.0,8655541,154728.0,1336174,3084,0.23
Italy,4893887,133034,0,4760853,10645,2.72,0.0,0.0,120822834,40505.0,4835435,58452,1.21
Jamaica,90467,2343,0,88124,97,2.59,0.0,0.0,2961161,30551.0,89926,541,0.6
Japan,1725458,18338,0,1707120,148,1.06,0.0,0.0,252643406,6830.0,1724379,1079,0.06
Jordan,905738,11310,0,894428,7056,1.25,0.0,0.0,10203140,88771.0,886042,19696,2.22
Kazakhstan,1043456,17601,0,1025855,1272,1.69,0.0,0.0,18776707,55572.0,1035051,8405,0.81
Kenya,254541,5325,0,249216,88,2.09,0.0,0.0,53771300,4734.0,254151,390,0.15
Kiribati,2,0,0,2,0,0.0,0.0,0.0,117606,17.0,2,0,0.0
"Korea, South",409099,3215,0,405884,3034,0.79,0.0,0.0,51269183,7979.0,390719,18380,4.7
Kosovo,160985,2980,0,158005,11,1.85,0.0,0.0,1793000,89785.0,160911,74,0.05
Kuwait,413090,2464,0,410626,22,0.6,0.0,0.0,4270563,96730.0,412936,154,0.04
Kyrgyzstan,182667,2715,0,179952,62,1.49,0.0,0.0,6524191,27998.0,182090,577,0.32
Laos,58798,116,0,58682,1401,0.2,0.0,0.0,7275556,8082.0,50977,7821,15.34
Latvia,244561,3901,0,240660,1221,1.6,0.0,0.0,1886202,129658.0,236765,7796,3.29
Lebanon,656192,8616,0,647576,1018,1.31,0.0,0.0,6825442,96139.0,649696,6496,1.0
Lesotho,21719,661,0,21058,0,3.04,0.0,0.0,2142252,10138.0,21687,32,0.15
Liberia,5818,287,0,5531,0,4.93,0.0,0.0,5057677,1150.0,5818,0,0.0
Libya,366789,5346,0,361443,551,1.46,0.0,0.0,6871287,53380.0,363483,3306,0.91
Liechtenstein,4041,61,0,3980,38,1.51,0.0,0.0,38137,105960.0,3841,200,5.21
Lithuania,450421,6440,0,443981,2117,1.43,0.0,0.0,2722291,165457.0,436690,13731,3.14
Luxembourg,85660,862,0,84798,299,1.01,0.0,0.0,625976,136842.0,84069,1591,1.89
MS Zaandam,9,2,0,7,0,22.22,0.0,0.0,0,50406.678756476686,9,0,0.0
Madagascar,43672,964,0,42708,0,2.21,0.0,0.0,27691019,1577.0,43672,0,0.0
Malawi,61858,2303,0,59555,4,3.72,0.0,0.0,19129955,3234.0,61834,24,0.04
Malaysia,2569533,29892,0,2539641,6380,1.16,0.0,0.0,64998698,39532.0,2528821,40712,1.61
Maldives,90340,248,0,90092,74,0.27,0.0,0.0,540542,167129.0,89364,976,1.09
Mali,16796,589,0,16207,38,3.51,0.0,0.0,20250834,829.0,16562,234,1.41
Malta,38449,462,0,37987,66,1.2,0.0,0.0,441539,87080.0,38067,382,1.0
Marshall Islands,4,0,0,4,0,0.0,0.0,0.0,58413,68.0,4,0,0.0
Mauritania,38440,812,0,37628,82,2.11,0.0,0.0,4649660,8267.0,37941,499,1.32
Mauritius,18979,240,0,18739,0,1.26,0.0,0.0,1271767,14923.0,18979,0,0.0
Mexico,3854994,291929,0,3563065,3915,7.57,0.0,0.0,255584572,15083.0,3838308,16686,0.43
Micronesia,1,0,0,1,0,0.0,0.0,0.0,113815,9.0,1,0,0.0
Moldova,356448,8709,0,347739,802,2.44,0.0,0.0,4033963,88362.0,350697,5751,1.64
Monaco,3536,36,0,3500,20,1.02,0.0,0.0,39244,90103.0,3467,69,1.99
Mongolia,376342,1925,0,374417,595,0.51,0.0,0.0,3278292,114798.0,370324,6018,1.63
Montenegro,153743,2231,0,151512,409,1.45,0.0,0.0,628062,244790.0,150793,2950,1.96
Morocco,948633,14755,0,933878,94,1.56,0.0,0.0,36910558,25701.0,947902,731,0.08
Mozambique,151472,1936,0,149536,6,1.28,0.0,0.0,31255435,4846.0,151410,62,0.04
Namibia,129074,3567,0,125507,5,2.76,0.0,0.0,2540916,50798.0,129027,47,0.04
Nepal,818307,11489,0,806818,272,1.4,0.0,0.0,29136808,28085.0,816060,2247,0.28
Netherlands,2419456,19307,0,2400149,23641,0.8,0.0,0.0,34882427,69360.0,2293385,126071,5.5
New Zealand,9653,38,0,9615,200,0.39,0.0,0.0,4839692,1995.0,8307,1346,16.2
Nicaragua,17023,211,0,16812,0,1.24,0.0,0.0,6624554,2570.0,16877,146,0.87
Niger,6773,237,0,6536,23,3.5,0.0,0.0,24206636,280.0,6626,147,2.22
Nigeria,213464,2973,0,210491,61,1.39,0.0,0.0,399640130,534.0,212947,517,0.24
North Macedonia,210938,7390,0,203548,491,3.5,0.0,0.0,2083380,101248.0,207998,2940,1.41
Norway,237739,996,0,236743,2425,0.42,0.0,0.0,5421242,43853.0,224302,13437,5.99
Oman,304466,4113,0,300353,13,1.35,0.0,0.0,5106622,59622.0,304410,56,0.02
Pakistan,1281240,28648,0,1252592,418,2.24,0.0,0.0,428724125,2988.0,1279142,2098,0.16
Palau,8,0,0,8,0,0.0,0.0,0.0,18008,444.0,8,0,0.0
Panama,475369,7350,0,468019,203,1.55,0.0,0.0,4314768,110173.0,474002,1367,0.29
Papua New Guinea,33337,436,0,32901,0,1.31,0.0,0.0,8947027,3726.0,32378,959,2.96
Paraguay,462146,16349,0,445797,37,3.54,0.0,0.0,7132530,64794.0,461574,572,0.12
Peru,2219617,200767,0,2018850,1415,9.05,0.0,0.0,65597846,33837.0,2211366,8251,0.37
Philippines,2821753,46422,0,2775331,1259,1.65,0.0,0.0,109581085,25750.0,2811248,10505,0.37
Poland,3279787,79994,0,3199793,24912,2.44,0.0,0.0,76257753,43009.0,3162804,116983,3.7
Portugal,1115080,18295,0,1096785,2398,1.64,0.0,0.0,10196707,109357.0,1102438,12642,1.15
Qatar,241672,611,0,241061,145,0.25,0.0,0.0,2881060,83883.0,240705,967,0.4
Romania,1755179,54343,0,1700836,3076,3.1,0.0,0.0,19237682,91237.0,1730433,24746,1.43
Russia,9063318,255448,0,8807870,36155,2.82,0.0,0.0,292579178,30977.0,8804297,259021,2.94
Rwanda,100190,1339,0,98851,7,1.34,0.0,0.0,12952209,7735.0,100047,143,0.14
Saint Kitts and Nevis,2764,28,0,2736,8,1.01,0.0,0.0,53109,52044.0,2735,29,1.06
Saint Lucia,12872,272,0,12600,21,2.11,0.0,0.0,183629,70098.0,12785,87,0.68
Saint Vincent and the Grenadines,5359,73,0,5286,33,1.36,0.0,0.0,110854,48343.0,5204,155,2.98
Samoa,3,0,0,3,0,0.0,0.0,0.0,196130,15.0,3,0,0.0
San Marino,5734,92,0,5642,23,1.6,0.0,0.0,33938,168955.0,5614,120,2.14
Sao Tome and Principe,3731,56,0,3675,0,1.5,0.0,0.0,219159,17024.0,3730,1,0.03
Saudi Arabia,549377,8821,0,540556,38,1.61,0.0,0.0,34813867,15780.0,549103,274,0.05
Senegal,73962,1883,0,72079,2,2.55,0.0,0.0,16743930,4417.0,73947,15,0.02
Serbia,1225242,11062,0,1214180,3219,0.9,0.0,0.0,8737370,140230.0,1201080,24162,2.01
Seychelles,22833,125,0,22708,52,0.55,0.0,0.0,98340,232184.0,22574,259,1.15
Sierra Leone,6400,121,0,6279,0,1.89,0.0,0.0,7976985,802.0,6400,0,0.0
Singapore,244815,619,0,244196,0,0.25,0.0,0.0,5850343,41846.0,230077,14738,6.41
Slovakia,1040996,13725,0,1027271,8756,1.32,0.0,0.0,5459643,190671.0,978203,62793,6.42
Slovenia,391677,5001,0,386676,3666,1.28,0.0,0.0,2078932,188403.0,368669,23008,6.24
Solomon Islands,20,0,0,20,0,0.0,0.0,0.0,652858,31.0,20,0,0.0
Somalia,22837,1313,0,21524,0,5.75,0.0,0.0,15893219,1437.0,22837,0,0.0
South Africa,2926914,89515,0,2837399,0,3.06,0.0,0.0,59308690,49351.0,2924978,1936,0.07
South Sudan,12609,133,0,12476,0,1.05,0.0,0.0,11193729,1126.0,12546,63,0.5
Spain,5074027,87804,0,4986223,6315,1.73,0.0,0.0,93691843,54157.0,5042803,31224,0.62
Sri Lanka,554459,14072,0,540387,737,2.54,0.0,0.0,21413250,25893.0,548061,6398,1.17
Sudan,41558,3099,0,38459,207,7.46,0.0,0.0,43849269,948.0,41093,465,1.13
Summer Olympics 2020,865,0,0,865,0,0.0,0.0,0.0,0,50406.678756476686,865,0,0.0
Suriname,50356,1143,0,49213,114,2.27,0.0,0.0,586634,85839.0,49902,454,0.91
Sweden,1187607,15109,0,1172498,1220,1.27,0.0,0.0,20426859,58139.0,1181532,6075,0.51
Switzerland,935047,11364,0,923683,6016,1.22,0.0,0.0,8654618,108040.0,905112,29935,3.31
Syria,46838,2689,0,44149,135,5.74,0.0,0.0,17500657,2676.0,45820,1018,2.22
Taiwan*,16506,848,0,15658,3,5.14,0.0,0.0,23806638,693.0,16465,41,0.25
Tajikistan,17489,125,0,17364,0,0.71,0.0,0.0,9537642,1834.0,17488,1,0.01
Tanzania,26227,727,0,25500,0,2.77,0.0,0.0,59734213,439.0,26196,31,0.12
Thailand,2044125,20254,0,2023871,6901,0.99,0.0,0.0,69799978,29285.0,1996969,47156,2.36
Timor-Leste,19814,122,0,19692,1,0.62,0.0,0.0,1318442,15028.0,19809,5,0.03
Togo,26185,243,0,25942,7,0.93,0.0,0.0,8278737,3163.0,26133,52,0.2
Tonga,1,0,0,1,0,0.0,0.0,0.0,105697,9.0,1,0,0.0
Trinidad and Tobago,64402,1908,0,62494,537,2.96,0.0,0.0,1399491,46018.0,60984,3418,5.6
Tunisia,715988,25330,0,690658,77,3.54,0.0,0.0,11818618,60581.0,715489,499,0.07
Turkey,8505190,74428,0,8430762,22234,0.88,0.0,0.0,84339067,100845.0,8342292,162898,1.95
US,47531319,768695,0,46762624,109578,1.62,0.0,0.0,330541757,143798.0,46866719,664600,1.42
Uganda,127073,3247,0,123826,27,2.56,0.0,0.0,45741000,2778.0,126763,310,0.24
Ukraine,3440602,84393,0,3356209,21810,2.45,0.0,0.0,89634808,38385.0,3303694,136908,4.14
United Arab Emirates,741214,2144,0,739070,66,0.29,0.0,0.0,9890400,74943.0,740729,485,0.07
United Kingdom,9772670,143999,0,9628671,48053,1.47,0.0,0.0,134862019,72464.0,9495395,277275,2.92
Uruguay,397318,6110,0,391208,175,1.54,0.0,0.0,3473727,114378.0,395964,1354,0.34
Uzbekistan,190584,1367,0,189217,252,0.72,0.0,0.0,33469199,5694.0,188892,1692,0.9
Vanuatu,6,1,0,5,0,16.67,0.0,0.0,292680,21.0,6,0,0.0
Venezuela,422229,5049,0,417180,0,1.2,0.0,0.0,28435943,14848.0,416190,6039,1.45
Vietnam,1065469,23476,0,1041993,10223,2.2,0.0,0.0,97338583,10946.0,1000897,64572,6.45
West Bank and Gaza,457729,4767,0,452962,252,1.04,0.0,0.0,4543126,100752.0,456407,1322,0.29
Yemen,9950,1934,0,8016,3,19.44,0.0,0.0,29825968,334.0,9907,43,0.43
Zambia,210036,3666,0,206370,16,1.75,0.0,0.0,18383956,11425.0,209953,83,0.04
Zimbabwe,133593,4699,0,128894,36,3.52,0.0,0.0,14862927,8988.0,133329,264,0.2